R 400 500
NO ./files/01.xpm
SO ./files/03.xpm
WE ./files/06.xpm
S ./files/text.xpm

F 99,101,99
EA ./files/07.xpm
C 62,63,62

 11111111111111111111
 1S111000000000100011
 10001000111110101011
  1101011110000101011
   100000111110001011
    11110111000111011
       10000000100011
       11011111001001
        1010001011101
       10010100010001
     1100000111111101
     1110011110111001
       10001110110001111111
        100000011100000000111
        1010101110011111000001
        10001111111111110011001
        1111111111111   1011101
                        1111111