R 250 200
NO ./files/01.xpm
SO ./files/02.xpm
WE ./files/03.xpm
S ./files/barrel.xpm

F 220,255,120
EA ./files/04.xpm
C 225,222,0



        1111111111111111111111111
        1000000000110000000000001
        1011000001110000002000001
        1001000000000000000000001
111111111011000001110000000000001
10000000001100000111010111111111
11110111111111010000000010001
1111011111111011101010010001
11000000110101011100000010001
1000200000000000100000000201
10000000000000001101010000001
1100000110101011111011100N0111
11111111 1110101 101111010001
1111 111 1111111 111111111111
