R 350 350
NO ./files/01.xpm
SO ./files/03.xpm
WE ./files/06.xpm
S ./files/text.xpm

F  239,24,24
EA ./files/07.xpm
C  65,67,77

 11111111111111111111
 1S111000000000100211
 10001000111110100011
  1201011110000101011
   100000111110001011
    11110111200111011
       10000000100011
       11011111001001
        1000000011101
       10010100010001
     1100002111111101
     11100111101110001
       10001110110001111111
        100000011100000002111
        1010101110011111000001
        10001111111111110011001
        1111111111111   10111001
                    11111111111
