R 400 500
NO ./files/01.xpm
SO ./files/03.xpm
WE ./files/06.xpm
S ./files/text.xpm

F 99,101,99
EA ./files/07.xpm
C 62,63,62

 1111111111111111111
 1S11100000000010001
 1000100011111010101
  110101111000010101
   10000011111000101
    1111011100011101
       1000000011001
       11011111111001
       1001111    111
       11111111111111

