R 400 500
NO ./files/code.xpm
SO ./files/matrix.xpm
WE ./files/03.xpm
S ./files/barrel.xpm

F 8,7,7
EA ./files/04.xpm
C 156,0,47


11111111111111111111
11111100000000001211
 100000000200000000011
  1000001000E0000200001
  120001 1000000000111
 11000001000002000011
 1111110001111111111
       111
