R 400 500
NO ./files/code.xpm
SO ./files/matrix.xpm
WE ./files/03.xpm
S ./files/barrel.xpm

F 8,7,7
EA ./files/04.xpm
C 156,0,47


11111111111111111111
11111100000000001111
 100000000000000000011
  1000001000E00000000001
  100001 1000000000111
 11000001000000000011
 1111111111111111111
