R 400 500
NO ./files/code.xpm
SO ./files/matrix.xpm
WE ./files/03.xpm
S ./files/barrel.xpm

F 8,7,7
EA ./files/04.xpm
C 156,0,47



11111111111111111111
11111111111111111111
11111111111111111111
11111100000000001111
10000000000000000001
1000000000E00000000011
10000000000000000001
10000000000000000011
111111111111111111 1