R 250 200
NO ./files/code.xpm
SO ./files/matrix.xpm
WE ./files/03.xpm
S ./files/barrel.xpm

F 8,7,7
EA ./files/04.xpm
C 156,0,47



  1111111111111111111111111 11
 10100000000011000000000000101 111
 111101100000111000000200000111111
101111100000000000000000000000 1111
1111111110110000011100000000001111
10000000001100000111010111111111011111
1011011011111101000000001000101011101
 11111111011111111011101010010010111
1 110000001101010111000000100010111111
1W00 1102000000200001000000002011
 11100000000000000011010100000011
    11110000011010101111101110001111
    11111111 1100101 0011110100011101
   1111 111 11 1111 1111111111111111
